9 164
~~~~~~~~~~~~~~~~~~~~~~~~~~~~~~~~~~~~~~~~~~~~~~~~~~~~~~~~~~~~~~~~~~~~~~~~~~~~~~~~~~~~~~~~~~~~~~~~~~~~~~~~~~~~~~~~~~~~~~~~~~~~~~~~~~~~~~~~~~~~~~~~~~~~~~~~~~~~~~~~~~~~
~~BBBBB~~B~~~~~~B~~BBBBB~~BBBBBBB~BBBBBBB~~~~B~~BBBBB~~BBBBBBB~B~~~~~B~B~~~~B~~~~~~~~~BBBBBBB~B~~~~~~B~~~~B~~~BBBBBBB~~~~~~~~~~BBBBB~~B~~~~~~B~BBBBBBB~BBBBBB~~B~~~~
~B~~~~~B~B~~~~~~B~B~~~~~B~~~~B~~~~B~~~~~~~~~B~~B~~~~~B~~~~B~~~~BB~~~~B~B~~~B~~~~~~~~~~~~~B~~~~B~~~~~~B~~~B~B~~~~~B~~~~~~~~~~~~B~~~~~B~B~~~~~~B~~~~B~~~~B~~~~~B~~B~~~
~B~~~~~~~B~~~~~~B~B~~~~~~~~~~B~~~~BBBBB~~~~B~~~B~~~~~~~~~~B~~~~B~B~~~B~B~~B~~~~~~~~~~~~~~B~~~~B~~~~~~B~~~B~B~~~~~B~~~~~~~~~~~~B~~~~~~~B~~~~~~B~~~~B~~~~B~~~~~B~~~B~~
~~BBBBB~~BBBBBBBB~B~~~~~~~~~~B~~~~B~~~~~~~B~~~~~BBBBB~~~~~B~~~~B~~B~~B~BB~~~~~~~~~~~~~~~~B~~~~BBBBBBBB~~BBBBB~~~~B~~~~~~~~~~~~~BBBBB~~BBBBBBBB~~~~B~~~~BBBBBB~~~~~B~
~~~~~~~B~B~~~~~~B~B~~~~~~~~~~B~~~~B~~~~~~~~B~~~~~~~~~B~~~~B~~~~B~~~B~B~B~~B~~~~~~~~~~~~~~B~~~~B~~~~~~B~~B~~~B~~~~B~~~~~~~~~~~~~~~~~~B~B~~~~~~B~~~~B~~~~B~~~~~~~~~B~~
~B~~~~~B~B~~~~~~B~B~~~~~B~~~~B~~~~B~~~~~~~~~B~~B~~~~~B~~~~B~~~~B~~~~BB~B~~~B~~~~~~~~~~~~~B~~~~B~~~~~~B~~B~~~B~~~~B~~~~~~~~~~~~B~~~~~B~B~~~~~~B~~~~B~~~~B~~~~~~~~B~~~
~~BBBBB~~B~~~~~~B~~BBBBB~~~~~B~~~~B~~~~~~~~~~B~~BBBBB~~BBBBBBB~B~~~~~B~B~~~~B~BBBBBBB~~~~B~~~~B~~~~~~B~~B~~~B~~~~B~~~~BBBBBBB~~BBBBB~~B~~~~~~B~BBBBBBB~B~~~~~~~B~~~~
~~~~~~~~~~~~~~~~~~~~~~~~~~~~~~~~~~~~~~~~~~~~~~~~~~~~~~~~~~~~~~~~~~~~~~~~~~~~~~~~~~~~~~~~~~~~~~~~~~~~~~~~~~~~~~~~~~~~~~~~~~~~~~~~~~~~~~~~~~~~~~~~~~~~~~~~~~~~~~~~~~~~